1111111
10001E1
10C0101
10P0001
1000110
1111110