111111111111111
1P0000000000001
100000000000001
100000000000001
100000000000001
100000111000001
100000111000001
100000000000001
100000000000001
10000000C000001
100000000000001
100000000000001
100000000000101
111111111111111
