11111111111111111111111111111111
10000000000000E000C000C00P000001
10000000000000000000000000000001
11111111111111111111111111111111