1111111
10001D1
1S1CC01
101CC01
1111111