1111111
17001D1
1S1CC01
1111111