1111111
10001E1
1000101
10P0001
1000110
1111111