1111111
10001E1
1000101
10P00C1
1000110
1111111