1111111
1000001
100C0D1
1S0C001
1111111