1111111
10CC1D1
10CC101
10P0C01
100CC01
1111111