1111111
10CC1D1
10CC101
10P0C01
100CCD1
1111111