1111111
10001D1
10P0C01
100CC01
1111111