1111111
1S001D1
101CC01
101CC01
1111111